####################
#O                 #
###      PX       ##
#            O       #
#    X       X      #
#                  ##
##########         #
######            ##
#O              ####
#     #         # O #
#     #     X   #   #
#     #             #
####     #########  #
 ######             #
   #################
