#####
#   #
# P #
# O #
# X #
#   #
#####